#111#
11111
11011
11111
#111#