##111##
##111##
1111111
1110111
1111111
##111##
##111##
