#1#1#
11111
11011
#111#
##1##