#############
#.....#.....#
#.S...#.....#
#.....#.....#
#.....#.....#
#.....#.....#
#...........#
#.....#.....#
#.....#.....#
#.....#.....#
#.....#.....#
#.....#.....#
###.#####.###
#.....#.....#
#.....#.....#
#.....#.....#
#.....#.....#
#.....#.....#
#...........#
#.....#.....#
#.....#.....#
#.....#.....#
#.....#...G.#
#.....#.....#
#############