###################
#.....#.....#.....#
#.S...#.....#.....#
#.....#.....#.....#
#.....#.....#.....#
#.....#.....#.....#
#...........#.....#
#.....#.....#.....#
#.....#.....#.....#
#.....#.....#.....#
#.....#.....#.....#
#.....#.....#.....#
###.#####.#####.###
#.....#.....#.....#
#.....#.....#.....#
#.....#.....#.....#
#.....#.....#.....#
#.....#.....#.....#
#.................#
#.....#.....#.....#
#.....#.....#.....#
#.....#.....#.....#
#.....#.....#...G.#
#.....#.....#.....#
###################